99999999999999999999
9.......1..........9
9.......1.....6....9
9.......1....6.....9
9..6.........6.....9
9..6...1....6......9
9666........66666669
9..................9
9.....1111.....1...9
9.....1.......111119
9........1.........9
9..................9
99999999999999999999