33333333333333333333
3...2..22..........3
3..................3
3....22.....11.....3
3....2........22...3
3........1.........3
3...2....1.........3
3........1..2......3
3........1.........3
33333333333333333333
