5555555555555555555
5........88888....5
5..............8..5
5.....444.........5
5......4....7.7...5
5......4......7...5
5...4.............5
5........7777.....5
5.................5
5555555555555555555
